33333333333333333333333333333333333333333333333333
30000000000000000000000000000000000000000000005503
30006666660000000666666666666666660000006600000003
30006000000000003000000000000000000000000000060003
30006660000000003000000000000000000000000006000003
30006000000000003003333333344444600000000000000003
30006666660000003003000000000000000000000000000003
30000000000000003003000000000000000000006000000003
30000000006600003003000000000000000000000000005503
30000000000000003003000000000000055000000000000003
30000000000000003003000000000000000000000000005503
30000000000000003003333333333000000000000000000003
30000000000000003000000000003000000000550000000003
30000000000000003000000000003000000000000000000003
30000500006600003333333333003333333000000000000003
30000050000000000000000003000000003000000000000003
30000000000000000000000003000000003000000000000003
30000005000000000000005533333333003330000000000003
30000000550000000000055553000000000001111111100003
30000000000000000000555555300000000001666666100003
30000000033333000000555555300006666001666666100003
30000000030003000000555555300006006001666666100003
30000000033333000000055533300006666001665566100003
30000000033000000000005300000006600003000000000003
30000000030300000004444444440006060003000000000003
30000000030030000003333333330006006003000000000003
30000000000000000003333633333333333333000000000003
30000000000000000004444444440066666552222223000003
30000000000000000000000000003365555222222233000003
30000000000000000000000000000065555200022223000003
30000000000000000000000000000065555233333333000003
30000000000000000000000000000065222230006000000003
30000000000000000000000000000065233300000000000003
30000777700000000000000000000065230000000000000003
30000000000000000000000000000065230000000000000003
30000000000000000000000000000065230000777770000003
30000000000000000000006555555555230000700070000003
30000000000000000005555622222222230000777770000003
30000000000000000005622222222222230000770000000003
30000000000000000502222222222222230000707000000003
30000000000000000502222222222222230000700700000003
30000000000000005022222222222222230000000000000003
30000000000000000444444444444444430000000000000003
30000003333300000000000000000000000000000000000003
30000006000600000000000000000000000000555055000003
30000000000000000000000000000000000005000500500003
30000000060000000000000077700000000000500005000003
30000060000600000000000006000000000000050050000003
30000006666000000000000000000000000000005500000003
33333333333333333333333333333333333333333333333333